|NME|tsserver-typescript
log|logOut|tsserver-javascript
|div|tsserver-javascript
currentUs|currentUser|tsserver-javascript
import {useAu|import { useAuth$1 } from '@redwoodjs/auth'|tsserver-javascript
isA|isAuthenticated|buffer
String|String|prisma
@uniq|@unique|prisma
autoin|autoincrement()|prisma
formMe|formMethods|tsserver-javascript
formMe|formMethods?|tsserver-javascript
useForm|useForm|around
error|error|snippets
FormErr|FormError|tsserver-javascript
import {UserInput|import { UserInputError$1 } from '@redwoodjs/graphql-server'|tsserver-javascript
suc|success|tsserver-javascript
onCo|onCompleted?|tsserver-javascript
Toast|Toaster|tsserver-javascript
err|error?|tsserver-javascript
@red|@redwoodjs/web|tsserver-javascript
useM|useMutation|tsserver-javascript
on|onBlur|tsserver-javascript
errorCla|errorClassName?|tsserver-javascript
FieldErr|FieldError|tsserver-javascript
requ|required?|tsserver-javascript
TextArea|TextAreaField|tsserver-javascript
onSubmit|onSubmit|tsserver-javascript
Submi|Submit|tsserver-javascript
|TextField|tsserver-javascript
TextFie|TextField|tsserver-javascript
Form|Form|tsserver-javascript
|Link|tsserver-javascript
Article|Article|tsserver-javascript
a|article|tsserver-javascript
Articl|Article|tsserver-javascript
@redwoo|@redwoodjs/router|tsserver-javascript
artic|article|tsserver-javascript
Ar|ArticleCell|tsserver-javascript
Article|ArticleCell|tsserver-javascript
title|title|emmet-javascriptreact
"git.enable|"git.enableGlobalStatus": ${1:true},|json
|ArticlesCell|tsserver-javascript
|shouldCloseOnBlur?|tsserver-typescript
org|org_data|around
|jest-extend-expect|tsserver-typescript
"eslint.auto|"eslint.autoFixOnSave": ${1:false},|json
first|firstChild|tsserver-typescript
contain|container|tsserver-typescript
la|label|buffer
scree|screen|tsserver-typescript
isVis|isVisuallyHidden?|tsserver-typescript
react|react|tsserver-typescript
imr|import statement|snippets
Visually|VisuallyHidden|buffer
routes|routes|tsserver-javascript
Link|Link|tsserver-javascript
w|when|around
body|body|emmet-javascriptreact
ti|ti|emmet-javascriptreact
import Article|import ArticlesCellStories$1 from 'src/components/ArticlesCell/ArticlesCell.stories'|tsserver-javascript
String|String|around
rcc|rcc|snippets
javascr|javascriptreact|buffer
p|p|tsserver-javascript
BlogLa|BlogLayout|tsserver-javascript
Set|Set|tsserver-javascript
|li|tsserver-javascript
|nav|tsserver-javascript
h1|h1|tsserver-javascript
|header>|tsserver-javascript
gruv|gruvbox|buffer
curso|cursor|around
markdo|markdown|around
line|line|around
fold|fold|around
pr|pre|tsserver-typescript
di|div|tsserver-typescript
div|div|tsserver-javascript
typesc|typescript|buffer
vim|vim|buffer
kitty|kitty|around
Maxi|Maximized|around